100000000000000000000000000000210000
000210000000000000000000000000330000
003112000000000000000000000000030000
003000200000000000000000000000033000
003000030001222000000000000000033000
003300030002002122220000000000033000
000000030022222132212000000000303000
000000030300000030222000000000300300
000000033300000011200000000000003300
001000303000002223000000000000003000
001320030000032003000000000000000000
000300030000000223120000000000000000
000030030000000003322220000000000000
000001033000300013000000000000000000
000001210000112120000000000000000000
000000000000000100000000000000000000
000000000000003300000000000000000000
000000000000003020000000000000000000
000000000000012200000000000000000000
000000000000000000000000000000000000
000000000000000000000000000000000000
000000000000000000000000000000000000
000000000000000000000000000000000000
